##########
   #   # #
 # # E # #
 # # #S# #
 # # ### #
 # # #   #
 # # # # #
 # # # # #
 # # # # #
 #     # #
